R 640 480
SO./textures/pic2.xpm
WE./textures/pic3.xpm
EA./textures/pic1.xpm
NO./textures/pic1.xpm

S./textures/pillar.xpm
F                                            220,100,0
C                                            0,255,255





















        111111111111111111111111
        1000000000110000000000021
        1011000001110000022200001        11
        10010000000E0000022200001      11021
111111111011000001110000000000001     12111
100000000011000001110111111111111      101
11110111111111011100000011001           1
11111111111111111111111111111
  
11111111111111111111111111111
11110111111111011101010010201
11000000101010111000000100011
10002000011100001100000000001
10000000000000001101010010001
1100000111010101111101111000111
11110111 1110101 101111010001
11111111 1111111 111111111111
 
 
  
11111111111
10000000001
11111111111
 